0 0 2 1 0 7 0 2 0 7 0 1 2 0 0
0 2 1 0 1 0 2 0 2 0 1 0 1 2 0
2 1 0 7 0 1 0 7 0 1 0 7 0 1 2
1 0 3 0 3 0 1 0 1 0 3 0 3 0 1
0 1 6 1 0 1 6 1 6 1 0 1 6 1 0
1 0 1 8 8 3 1 3 1 3 8 8 1 0 1
1 0 1 8 8 3 1 3 1 3 8 8 1 0 1
0 1 6 1 0 1 6 1 6 1 0 1 6 1 0
1 0 3 0 3 0 1 0 1 0 3 0 3 0 1
2 1 0 7 0 1 0 7 0 1 0 7 0 1 2
0 2 1 0 1 0 2 0 2 0 1 0 1 2 0
0 0 2 1 0 7 0 2 0 7 0 1 2 0 0